NO ./textures/BRICK_3D.xpm
WE ./textures/FLOOR_1B.xpm
SO ./textures/STUCCO_1D.xpm
EA ./textures/TECH_5A.xpm

F 128,180,30
C 90,150, 200




  11111111111111111111111
        100000100000001
        1D100111111111111111111111
        10000011000000000000010001
        10000010000000000000000001
        10000011000000000000010001
        11101111111011111111110001
        110000110000001      10001
        100000010000001      10001
        100000010000001      10001
        100000000000001111111110111111111111
        100000010000001000000000000000000011
        100000010000001000000000000000000011111
        110000110000001001110000000000110010001
        111111111111111001000000000000010010001
                      1000000000000000000010001
                      1000000000000000000010001
                      1000000000000000000000011
                      1000000000000000000010001
                      1000000000000000000010001
                      1001000000000000010010001
                      1001100000000000110010001
                      1000000000000000000010001
           1111111111111000000000000000000100011
           100001D100001111111111111111111100011
           100001D100001                11100011
           100001D100001               11110001111
           100001D100001               10000000001
           100001D100001               10000000001
           100001D100001               10000000001
           100001D100001               10000000001
           100001D100001              110000000001
           100001D100001              101000001011
           100001D100001              110000000001
           1001D1D11D1111111111111     11111011111
           10000000000000000000001       100001
           11110000000000000000001       100001
              100000000S0000000001      1100001
          1111100000000100011101111111111000011
          1000000000001000100001000000000000001
          100001000000D000000000000000000000001
          1000100000001000010001000000000000001
          1000111111011111110000000001D10000011
          1000000010001    11101111111111111111
          1000000000001    100000000001
          1000000010001    100000000001
          1111011110001    100000000001
            10001 10101    100000000001
            10001110111    100000000001
            10000000001    100000000001
            11111100001    111111011111
            1111111100111111111111111
                  111000000111111111111111111111111111111111111111
                    1111110000010001000001000000010000000001010001
                        111010101010111010111011101110111010111011
                        10001000101010101000100000101010000000001
                        10101110111110101111111010101110111111111
                        10101010100000000010000010100010100010001
                        10111011111111111010111110101111111010101
                        10101010001000001010000010000010100000101
                        10101010101110111011101011111110111111101
                        10000010101000001000001010100010001000001
                        10101010111111101110111110101111101011101
                        10101000000010000010000000000010000000101
                        11101010111110111010101011101110111111111
                        10101010000000100000101000100000100000001
                        10101110111010111010101111111110101111101
                        10001000001010001010101000000010000010101
                        10111011101110101011111011101110111010101
                        10100010001010101000001000100010001010101
                        10111010101011101111101011101111101010101
                        10100010101000101000100000100010101010001
                        10111010101110101110101011111110111011101
                        10101010100000101000001000100010001010101
                        10101110101111111110101111101110101010101
                        10001000100010000000100010000010101010101
                        10101011101010101111111110111110111010111
                        10101010001010100000000000100000100010001
                        10101011111011111111111110101111111111101
                        10101000101000001000001000101000001000001
                        11101110101111111010111110101010111011111
                        10001000000010000010100010000010100000001
                        10111111111011101010101111111110111111101
                        10100000001000001010000010000010001010001
                        11101010111110111011111010111111101010101
                        10001010100000100000001010100000100010101
                        11111111111111111111111111111111111111111
